5 5 5 5 5 5 5 5 5 5 5 5 5 5 5 5 5 5 5 5 5 5 5 5 5 5 5 5
5 5 5 5 5 5 5 5 5 5 5 5 5 5 5 5 5 5 5 5 5 5 5 5 5 5 5 5
5 5 5 5 5 5 5 5 5 5 5 5 5 5 5 5 5 5 5 5 5 5 5 5 5 5 5 5
5 5 5 5 5 5 5 5 5 5 5 5 5 5 5 5 5 5 5 5 5 5 5 5 5 5 5 5
5 5 5 5 5 5 5 5 5 5 5 5 5 5 5 5 5 5 5 5 5 5 5 5 5 5 5 5
5 5 5 5 5 5 5 5 5 5 5 5 5 5 5 5 5 5 5 5 5 5 5 5 5 5 5 5
5 5 5 5 5 5 5 5 5 5 5 5 5 5 5 5 5 5 5 5 5 5 5 5 5 5 5 5
5 5 5 5 5 5 5 5 5 5 5 5 5 5 5 5 5 5 5 5 5 5 5 5 5 5 5 5
5 5 5 5 5 5 1 1 1 1 0 0 0 1 1 1 1 1 1 1 1 1 5 5 5 5 5 5
5 5 5 5 5 5 0 0 0 0 0 0 0 0 0 0 0 0 0 0 0 0 5 5 5 5 5 5
5 5 5 5 5 5 0 0 0 0 0 0 0 0 0 0 0 0 0 0 0 0 5 5 5 5 5 5
5 5 5 5 5 5 1 1 1 0 0 1 1 2 2 1 1 1 1 1 1 1 5 5 5 5 5 5
5 5 5 5 5 5 3 3 3 3 3 3 3 3 3 3 3 3 3 3 3 3 5 5 5 5 5 5
5 5 5 5 5 5 3 3 4 4 4 3 4 4 4 3 4 4 4 3 3 3 5 5 5 5 5 5
5 5 5 5 5 5 3 3 3 3 3 3 3 3 3 3 3 3 3 3 3 3 5 5 5 5 5 5
5 5 5 5 5 5 1 1 0 1 1 1 0 0 0 1 1 0 0 1 1 1 5 5 5 5 5 5
5 5 5 5 5 5 0 0 0 0 0 0 0 0 0 0 0 0 0 0 0 0 5 5 5 5 5 5
5 5 5 5 5 5 0 0 0 0 0 0 0 0 0 0 0 0 0 0 0 0 5 5 5 5 5 5
5 5 5 5 5 5 1 1 1 0 0 1 1 1 1 1 1 0 0 1 1 1 5 5 5 5 5 5
5 5 5 5 5 5 3 3 3 3 3 3 3 3 3 3 3 3 3 3 3 3 5 5 5 5 5 5
5 5 5 5 5 5 3 3 4 4 4 3 4 4 4 3 4 4 4 3 3 3 5 5 5 5 5 5
5 5 5 5 5 5 3 3 3 3 3 3 3 3 3 3 3 3 3 3 3 3 5 5 5 5 5 5
5 5 5 5 5 5 1 1 0 1 1 1 0 0 0 1 1 0 0 1 1 1 5 5 5 5 5 5
5 5 5 5 5 5 0 0 0 0 0 0 0 0 0 0 0 0 0 0 0 0 5 5 5 5 5 5
5 5 5 5 5 5 0 0 0 0 0 0 0 0 0 0 0 0 0 0 0 0 5 5 5 5 5 5
5 5 5 5 5 5 3 3 3 3 3 3 3 3 3 3 3 3 3 3 3 3 5 5 5 5 5 5
5 5 5 5 5 5 3 3 4 4 4 3 4 4 4 3 4 4 4 3 3 3 5 5 5 5 5 5
5 5 5 5 5 5 3 3 3 3 3 3 3 3 3 3 3 3 3 3 3 3 5 5 5 5 5 5
5 5 5 5 5 5 1 1 1 0 0 1 1 1 1 1 1 0 0 1 1 1 5 5 5 5 5 5
5 5 5 5 5 5 0 0 0 0 0 0 0 0 0 0 0 0 0 0 0 0 5 5 5 5 5 5
5 5 5 5 5 5 0 0 0 0 0 0 0 0 0 0 0 0 0 0 0 0 5 5 5 5 5 5
5 5 5 5 5 5 1 1 1 0 0 0 0 0 0 1 1 1 2 2 0 1 5 5 5 5 5 5
5 5 5 5 5 5 3 3 3 3 3 3 3 3 3 3 3 3 3 3 3 3 5 5 5 5 5 5
5 5 5 5 5 5 3 3 4 4 4 3 4 4 4 3 4 4 4 3 3 3 5 5 5 5 5 5
5 5 5 5 5 5 3 3 3 3 3 3 3 3 3 3 3 3 3 3 3 3 5 5 5 5 5 5
5 5 5 5 5 5 1 1 1 1 0 0 0 1 1 1 1 1 1 1 1 1 5 5 5 5 5 5
5 5 5 5 5 5 0 0 0 0 0 0 0 0 0 0 0 0 0 0 0 0 5 5 5 5 5 5
5 5 5 5 5 5 0 0 0 0 0 0 0 0 0 0 0 0 0 0 0 0 5 5 5 5 5 5
5 5 5 5 5 5 1 1 1 0 0 1 1 2 2 1 1 1 1 1 1 1 5 5 5 5 5 5
5 5 5 5 5 5 3 3 3 3 3 3 3 3 3 3 3 3 3 3 3 3 5 5 5 5 5 5
5 5 5 5 5 5 3 3 4 4 4 3 4 4 4 3 4 4 4 3 3 3 5 5 5 5 5 5
5 5 5 5 5 5 3 3 3 3 3 3 3 3 3 3 3 3 3 3 3 3 5 5 5 5 5 5
5 5 5 5 5 5 1 1 0 1 1 1 0 0 0 1 1 0 0 1 1 1 5 5 5 5 5 5
5 5 5 5 5 5 0 0 0 0 0 0 0 0 0 0 0 0 0 0 0 0 5 5 5 5 5 5
5 5 5 5 5 5 0 0 0 0 0 0 0 0 0 0 0 0 0 0 0 0 5 5 5 5 5 5
5 5 5 5 5 5 1 1 1 0 0 1 1 1 1 1 1 0 0 1 1 1 5 5 5 5 5 5
5 5 5 5 5 5 3 3 3 3 3 3 3 3 3 3 3 3 3 3 3 3 5 5 5 5 5 5
5 5 5 5 5 5 3 3 4 4 4 3 4 4 4 3 4 4 4 3 3 3 5 5 5 5 5 5
5 5 5 5 5 5 3 3 3 3 3 3 3 3 3 3 3 3 3 3 3 3 5 5 5 5 5 5
5 5 5 5 5 5 1 0 0 0 0 0 0 0 0 0 0 0 0 0 0 1 5 5 5 5 5 5
5 5 5 5 5 5 1 0 0 0 0 0 0 0 0 0 0 0 0 0 0 1 5 5 5 5 5 5
5 5 5 5 5 5 1 0 0 0 0 0 0 0 0 0 0 0 0 0 0 1 5 5 5 5 5 5
5 5 5 5 5 5 5 5 5 5 5 5 5 5 5 5 5 5 5 5 5 5 5 5 5 5 5 5
5 5 5 5 5 5 5 5 5 5 5 5 5 5 5 5 5 5 5 5 5 5 5 5 5 5 5 5
5 5 5 5 5 5 5 5 5 5 5 5 5 5 5 5 5 5 5 5 5 5 5 5 5 5 5 5
5 5 5 5 5 5 5 5 5 5 5 5 5 5 5 5 5 5 5 5 5 5 5 5 5 5 5 5
5 5 5 5 5 5 5 5 5 5 5 5 5 5 5 5 5 5 5 5 5 5 5 5 5 5 5 5
5 5 5 5 5 5 5 5 5 5 5 5 5 5 5 5 5 5 5 5 5 5 5 5 5 5 5 5
5 5 5 5 5 5 5 5 5 5 5 5 5 5 5 5 5 5 5 5 5 5 5 5 5 5 5 5
5 5 5 5 5 5 5 5 5 5 5 5 5 5 5 5 5 5 5 5 5 5 5 5 5 5 5 5
